.................................
.................................
.................................
...##...##...##...DD...##...##...
...##...##...##...DD...##...##...
.................................
.................................
.................................
...##...##...##...##...##...##...
...##...##...##...##...##...##...
.................................
.................................
.................................
...##...##...CC...##...##...##...
...##...##...CC...##...##...##...
.................................
.................................
.................................
...##...##...##...##...##...##...
...##...##...##...##...##...##...
.................................
.................................
.................................
...##...##...##...##...BB...##...
...##...##...##...##...BB...##...
.................................
.................................
.................................
...##...AA...##...##...##...##...
...##...AA...##...##...##...##...
.................................
.................................
.................................
...##...##...##...##...##...##...
...##...##...##...##...##...##...
.................................
.................................
.................................
