.....................
.....................
..###...........###..
..#....A.....C....#..
..#...AAA...CCD...#..
.....AAABBBCCDDD.....
......ABBBCCDDD......
.......BBCCDDD.......
........CCDDD........
..#......DDD......#..
..#.......D.......#..
..###...........###..
.....................
.....................
